author	 a u t h o r |
of	 o f |
the	 t h e |
danger	 d a n g e r |
trail	 t r a i l |
philip	 p h i l i p |
steels	 s t e e l s |
etc	 e t c |
not	 n o t |
at	 a t |
this	 t h i s |
particular	 p a r t i c u l a r |
case	 c a s e |
tom	 t o m |
apologized	 a p o l o g i z e d |
whittemore	 w h i t t e m o r e |
if	 i f |
i	 i |
ever	 e v e r |
needed	 n e e d e d |
a	 a |
fighter	 f i g h t e r |
in	 i n |
my	 m y |
life	 l i f e |
need	 n e e d |
one	 o n e |
now	 n o w |
you	 y o u |
would	 w o u l d |
keep	 k e e p |
truth	 t r u t h |
from	 f r o m |
me	 m e |
have	 h a v e |
all	 a l l |
advantage	 a d v a n t a g e |
dirk	 d i r k |
mentioned	 m e n t i o n e d |
by	 b y |
wolf	 w o l f |
larsen	 l a r s e n |
rested	 r e s t e d |
its	 i t s |
sheath	 s h e a t h |
on	 o n |
hip	 h i p |
earned	 e a r n e d |
dollar	 d o l l a r |
your	 y o u r |
own	 o w n |
labour	 l a b o u r |
he	 h e |
gave	 g a v e |
no	 n o |
reason	 r e a s o n |
but	 b u t |
his	 h i s |
motive	 m o t i v e |
was	 w a s |
obvious	 o b v i o u s |
enough	 e n o u g h |
ah	 a h |
it	 i t |
sweet	 s w e e t |
ears	 e a r s |
may	 m a y |
desire	 d e s i r e |
to	 t o |
escape	 e s c a p e |
pain	 p a i n |
or	 o r |
enjoy	 e n j o y |
pleasure	 p l e a s u r e |
impossible	 i m p o s s i b l e |
hoist	 h o i s t |
sail	 s a i l |
and	 a n d |
claw	 c l a w |
off	 o f f |
that	 t h a t |
shore	 s h o r e |
there	 t h e r e |
nothing	 n o t h i n g |
for	 f o r |
us	 u s |
wide	 w i d e |
raw	 r a w |
ocean	 o c e a n |
arose	 a r o s e |
obediently	 o b e d i e n t l y |
went	 w e n t |
down	 d o w n |
beach	 b e a c h |
next	 n e x t |
thing	 t h i n g |
watch	 w a t c h |
out	 o u t |
is	 i s |
bed	 b e d |
sores	 s o r e s |
will	 w i l l |
follow	 f o l l o w |
soon	 s o o n |
moment	 m o m e n t |
got	 g o t |
impression	 i m p r e s s i o n |
she	 s h e |
willowy	 w i l l o w y |
fathers	 f a t h e r s |
fifth	 f i f t h |
command	 c o m m a n d |
nodded	 n o d d e d |
occasion	 o c c a s i o n |
traverse	 t r a v e r s e |
cape	 c a p e |
verde	 v e r d e |
islands	 i s l a n d s |
are	 a r e |
raised	 r a i s e d |
essentially	 e s s e n t i a l l y |
lifegiving	 l i f e g i v i n g |
lifeconserving	 l i f e c o n s e r v i n g |
female	 f e m a l e |
species	 s p e c i e s |
also	 a l s o |
regular	 r e g u l a r |
intervals	 i n t e r v a l s |
mutter	 m u t t e r |
very	 v e r y |
tenable	 t e n a b l e |
hypothesis	 h y p o t h e s i s |
bear	 b e a r |
looking	 l o o k i n g |
into	 i n t o |
were	 w e r e |
orangegreen	 o r a n g e g r e e n |
goldgreen	 g o l d g r e e n |
coppergreen	 c o p p e r g r e e n |
gabriel	 g a b r i e l |
voice	 v o i c e |
samurai	 s a m u r a i |
rang	 r a n g |
sunsets	 s u n s e t s |
grow	 g r o w |
more	 m o r e |
bizarre	 b i z a r r e |
spectacular	 s p e c t a c u l a r |
coast	 c o a s t |
argentine	 a r g e n t i n e |
came	 c a m e |
promise	 p r o m i s e |
bow	 b o w |
canoe	 c a n o e |
history	 h i s t o r y |
our	 o u r |
westwardfaring	 w e s t w a r d f a r i n g |
race	 r a c e |
written	 w r i t t e n |
eurasian	 e u r a s i a n |
chineseenglishman	 c h i n e s e e n g l i s h m a n |
bowed	 b o w e d |
himself	 h i m s e l f |
away	 a w a y |
they	 t h e y |
babbling	 b a b b l i n g |
chattering	 c h a t t e r i n g |
together	 t o g e t h e r |
too	 t o o |
much	 m u c h |
told	 t o l d |
with	 w i t h |
ominous	 o m i n o u s |
rolling	 r o l l i n g |
head	 h e a d |
candidate	 c a n d i d a t e |
rising	 r i s i n g |
serf	 s e r f |
class	 c l a s s |
we	 w e |
cooking	 c o o k i n g |
coal	 c o a l |
stove	 s t o v e |
oil	 o i l |
burners	 b u r n e r s |
steward	 s t e w a r d |
has	 h a s |
just	 j u s t |
tendered	 t e n d e r e d |
respectful	 r e s p e c t f u l |
bit	 b i t |
advice	 a d v i c e |
well	 w e l l |
did	 d i d |
eat	 e a t |
famine	 f a m i n e |
had	 h a d |
been	 b e e n |
great	 g r e a t |
ally	 a l l y |
nowhere	 n o w h e r e |
north	 n o r t h |
soil	 s o i l |
so	 s o |
prolific	 p r o l i f i c |
sleeping	 s l e e p i n g |
under	 u n d e r |
protection	 p r o t e c t i o n |
as	 a s |
sweetly	 s w e e t l y |
child	 c h i l d |
ran	 r a n |
climbed	 c l i m b e d |
high	 h i g h |
earth	 e a r t h |
bank	 b a n k |
land	 l a n d |
exchanged	 e x c h a n g e d |
austere	 a u s t e r e |
robes	 r o b e s |
garb	 g a r b |
smiling	 s m i l i n g |
wanton	 w a n t o n |
stir	 s t i r |
bustle	 b u s t l e |
new	 n e w |
faces	 f a c e s |
fresh	 f r e s h |
facts	 f a c t s |
ethel	 e t h e l |
baird	 b a i r d |
whom	 w h o m |
must	 m u s t |
remember	 r e m e m b e r |
become	 b e c o m e |
man	 m a n |
early	 e a r l y |
think	 t h i n k |
be	 b e |
know	 k n o w |
what	 w h a t |
minds	 m i n d s |
superiors	 s u p e r i o r s |
mops	 m o p s |
sir	 s i r |
eagerly	 e a g e r l y |
answered	 a n s w e r e d |
sailor	 s a i l o r |
wheel	 w h e e l |
some	 s o m e |
thrust	 t h r u s t |
large	 l a r g e |
sheathknife	 s h e a t h k n i f e |
hand	 h a n d |
obrien	 o b r i e n |
emitted	 e m i t t e d |
shriek	 s h r i e k |
sank	 s a n k |
swiftly	 s w i f t l y |
gurgling	 g u r g l i n g |
sob	 s o b |
only	 o n l y |
wonderful	 w o n d e r f u l |
almost	 a l m o s t |
believe	 b e l i e v e |
sandel	 s a n d e l |
never	 n e v e r |
world	 w o r l d |
champion	 c h a m p i o n |
wouldnt	 w o u l d n t |
walk	 w a l k |
dearest	 d e a r e s t |
always	 a l w a y s |
appreciated	 a p p r e c i a t e d |
friend	 f r i e n d |
submit	 s u b m i t |
myself	 m y s e l f |
used	 u s e d |
joyride	 j o y r i d e |
like	 l i k e |
devil	 d e v i l |
saw	 s a w |
each	 e a c h |
other	 o t h e r |
first	 f i r s t |
time	 t i m e |
boston	 b o s t o n |
isaac	 i s a a c |
ford	 f o r d |
soldier	 s o l d i e r |
lord	 l o r d |
old	 o l d |
hypocrite	 h y p o c r i t e |
eighteen	 e i g h t e e n |
added	 a d d e d |
reward	 r e w a r d |
should	 s h o u l d |
peace	 p e a c e |
repose	 r e p o s e |
an	 a n |
amphibian	 a m p h i b i a n |
mountaineer	 m o u n t a i n e e r |
sanctification	 s a n c t i f i c a t i o n |
salvation	 s a l v a t i o n |
emotion	 e m o t i o n |
which	 w h i c h |
suppressed	 s u p p r e s s e d |
burst	 b u r s t |
forth	 f o r t h |
choking	 c h o k i n g |
eighteenth	 e i g h t e e n t h |
century	 c e n t u r y |
ernest	 e r n e s t |
prompted	 p r o m p t e d |
biologists	 b i o l o g i s t s |
nor	 n o r |
sociologists	 s o c i o l o g i s t s |
opponents	 o p p o n e n t s |
grew	 g r e w |
excited	 e x c i t e d |
deliberately	 d e l i b e r a t e l y |
them	 t h e m |
virtue	 v i r t u e |
power	 p o w e r |
shall	 s h a l l |
remain	 r e m a i n |
guess	 g u e s s |
do	 d o |
retorted	 r e t o r t e d |
take	 t a k e |
accept	 a c c e p t |
vacation	 v a c a t i o n |
could	 c o u l d |
agree	 a g r e e |
such	 s u c h |
divergence	 d i v e r g e n c e |
opinion	 o p i n i o n |
constitute	 c o n s t i t u t e |
menace	 m e n a c e |
society	 s o c i e t y |
dog	 d o g |
ate	 a t e |
up	 u p |
let	 l e t |
run	 r u n |
ourselves	 o u r s e l v e s |
how	 h o w |
thank	 t h a n k |
introduced	 i n t r o d u c e d |
representative	 r e p r e s e n t a t i v e |
dick	 d i c k |
ohio	 o h i o |
few	 f e w |
people	 p e o p l e |
knew	 k n e w |
existence	 e x i s t e n c e |
law	 l a w |
agreed	 a g r e e d |
fellow	 f e l l o w |
senator	 s e n a t o r |
chauncey	 c h a u n c e y |
depew	 d e p e w |
said	 s a i d |
affair	 a f f a i r |
most	 m o s t |
sinister	 s i n i s t e r |
import	 i m p o r t |
then	 t h e n |
campaign	 c a m p a i g n |
manifestly	 m a n i f e s t l y |
distressed	 d i s t r e s s e d |
coming	 c o m i n g |
moved	 m o v e d |
empire	 e m p i r e |
reorganization	 r e o r g a n i z a t i o n |
these	 t h e s e |
countries	 c o u n t r i e s |
took	 t o o k |
form	 f o r m |
revolution	 r e v o l u t i o n |
youre	 y o u r e |
going	 g o i n g |
grab	 g r a b |
sharing	 s h a r i n g |
waded	 w a d e d |
edge	 e d g e |
water	 w a t e r |
began	 b e g a n |
scrubbing	 s c r u b b i n g |
oligarchy	 o l i g a r c h y |
encourage	 e n c o u r a g e |
ambition	 a m b i t i o n |
consequent	 c o n s e q u e n t |
competition	 c o m p e t i t i o n |
violation	 v i o l a t i o n |
made	 m a d e |
misdemeanor	 m i s d e m e a n o r |
punished	 p u n i s h e d |
accordingly	 a c c o r d i n g l y |
without	 w i t h o u t |
discussion	 d i s c u s s i o n |
agents	 a g e n t s |
provocateurs	 p r o v o c a t e u r s |
who	 w h o |
caused	 c a u s e d |
peasant	 p e a s a n t |
revolt	 r e v o l t |
task	 t a s k |
set	 s e t |
threefold	 t h r e e f o l d |
many	 m a n y |
similar	 s i m i l a r |
disconcerting	 d i s c o n c e r t i n g |
omissions	 o m i s s i o n s |
noticed	 n o t i c e d |
manuscript	 m a n u s c r i p t |
flower	 f l o w e r |
artistic	 a r t i s t i c |
intellectual	 i n t e l l e c t u a l |
revolutionists	 r e v o l u t i o n i s t s |
iron	 i r o n |
heel	 h e e l |
foresaw	 f o r e s a w |
laid	 l a i d |
schemes	 s c h e m e s |
mob	 m o b |
advance	 a d v a n c e |
why	 w h y |
continue	 c o n t i n u e |
tirade	 t i r a d e |
after	 a f t e r |
superfluous	 s u p e r f l u o u s |
flesh	 f l e s h |
gone	 g o n e |
left	 l e f t |
stringy	 s t r i n g y |
resistant	 r e s i s t a n t |
shaking	 s h a k i n g |
confidence	 c o n f i d e n c e |
beyond	 b e y o n d |
refusing	 r e f u s i n g |
sell	 s e l l |
food	 f o o d |
merry	 m e r r y |
monarch	 m o n a r c h |
especially	 e s p e c i a l l y |
asiatic	 a s i a t i c |
whispering	 w h i s p e r i n g |
conferring	 c o n f e r r i n g |
place	 p l a c e |
jacob	 j a c o b |
brinker	 b r i n k e r |
roadmate	 r o a d m a t e |
brought	 b r o u g h t |
news	 n e w s |
thus	 t h u s |
turned	 t u r n e d |
tenets	 t e n e t s |
jargon	 j a r g o n |
psychology	 p s y c h o l o g y |
back	 b a c k |
yellow	 y e l l o w |
giant	 g i a n t |
frost	 f r o s t |
strange	 s t r a n g e |
prophet	 p r o p h e t |
jerusalem	 j e r u s a l e m |
endured	 e n d u r e d |
surely	 s u r e l y |
can	 c a n |
endure	 e n d u r e |
little	 l i t t l e |
seen	 s e e n |
contemplated	 c o n t e m p l a t e d |
pascals	 p a s c a l s |
philosophic	 p h i l o s o p h i c |
eye	 e y e |
drawback	 d r a w b a c k |
farming	 f a r m i n g |
california	 c a l i f o r n i a |
long	 l o n g |
dry	 d r y |
summer	 s u m m e r |
replied	 r e p l i e d |
jeanne	 j e a n n e |
tersely	 t e r s e l y |
remembered	 r e m e m b e r e d |
red	 r e d |
wine	 w i n e |
italian	 i t a l i a n |
rancho	 r a n c h o |
shuddered	 s h u d d e r e d |
inwardly	 i n w a r d l y |
dismissed	 d i s m i s s e d |
matter	 m a t t e r |
worth	 w o r t h |
thinking	 t h i n k i n g |
about	 a b o u t |
boy	 b o y |
code	 c o d e |
wherever	 w h e r e v e r |
ranged	 r a n g e d |
way	 w a y |
lay	 l a y |
along	 a l o n g |
alcoholdrenched	 a l c o h o l d r e n c h e d |
roads	 r o a d s |
hurried	 h u r r i e d |
town	 t o w n |
joe	 j o e |
goose	 g o o s e |
explained	 e x p l a i n e d |
scents	 s c e n t s |
vegetation	 v e g e t a t i o n |
blew	 b l e w |
tropic	 t r o p i c |
healthful	 h e a l t h f u l |
athletic	 a t h l e t i c |
juvenile	 j u v e n i l e |
valiantly	 v a l i a n t l y |
day	 d a y |
help	 h e l p |
tide	 t i d e |
until	 u n t i l |
steady	 s t e a d y |
employment	 e m p l o y m e n t |
possess	 p o s s e s s |
vitality	 v i t a l i t y |
gregson	 g r e g s o n |
shoved	 s h o v e d |
chair	 c h a i r |
rose	 r o s e |
feet	 f e e t |
instead	 i n s t e a d |
joined	 j o i n e d |
her	 h e r |
two	 t w o |
hungry	 h u n g r y |
children	 c h i l d r e n |
anxiety	 a n x i e t y |
solicitude	 s o l i c i t u d e |
love	 l o v e |
count	 c o u n t |
fulfilled	 f u l f i l l e d |
duty	 d u t y |
paid	 p a i d |
properly	 p r o p e r l y |
taboos	 t a b o o s |
violating	 v i o l a t i n g |
value	 v a l u e |
hide	 h i d e |
when	 w h e n |
heard	 h e a r d |
spitting	 s p i t t i n g |
chinook	 c h i n o o k |
plodded	 p l o d d e d |
half	 h a l f |
hour	 h o u r |
hallucination	 h a l l u c i n a t i o n |
again	 a g a i n |
tomorrow	 t o m o r r o w |
might	 m i g h t |
already	 a l r e a d y |
composed	 c o m p o s e d |
zilla	 z i l l a |
relaxed	 r e l a x e d |
sour	 s o u r |
mouth	 m o u t h |
sigh	 s i g h |
satisfaction	 s a t i s f a c t i o n |
wounded	 w o u n d e d |
arm	 a r m |
talk	 t a l k |
witchcraft	 w i t c h c r a f t |
village	 v i l l a g e |
yea	 y e a |
tell	 t e l l |
thee	 t h e e |
hans	 h a n s |
hurled	 h u r l e d |
upon	 u p o n |
prostrate	 p r o s t r a t e |
striking	 s t r i k i n g |
madly	 m a d l y |
fists	 f i s t s |
thought	 t h o u g h t |
oona	 o o n a |
words	 w o r d s |
thaw	 t h a w |
hands	 h a n d s |
russian	 r u s s i a n |
music	 m u s i c |
player	 p l a y e r |
obedient	 o b e d i e n t |
slave	 s l a v e |
far	 f a r |
flags	 f l a g s |
concerned	 c o n c e r n e d |
jurisdiction	 j u r i s d i c t i o n |
idea	 i d e a |
volunteered	 v o l u n t e e r e d |
brand	 b r a n d |
thirty	 t h i r t y |
pounds	 p o u n d s |
captain	 c a p t a i n |
finality	 f i n a l i t y |
preposterous	 p r e p o s t e r o u s |
suppose	 s u p p o s e |
picked	 p i c k e d |
lingo	 l i n g o |
among	 a m o n g |
indians	 i n d i a n s |
doanes	 d o a n e s |
orders	 o r d e r s |
obeyed	 o b e y e d |
come	 c o m e |
del	 d e l |
mar	 m a r |
challenged	 c h a l l e n g e d |
big	 b i g |
chimpanzee	 c h i m p a n z e e |
winner	 w i n n e r |
am	 a m |
sure	 s u r e |
adventure	 a d v e n t u r e |
longfellow	 l o n g f e l l o w |
chap	 c h a p |
likely	 l i k e l y |
countless	 c o u n t l e s s |
books	 b o o k s |
poetry	 p o e t r y |
abnormal	 a b n o r m a l |
vision	 v i s i o n |
abstractions	 a b s t r a c t i o n s |
concrete	 c o n c r e t e |
ill	 i l l |
librarian	 l i b r a r i a n |
brightening	 b r i g h t e n i n g |
face	 f a c e |
read	 r e a d |
fragments	 f r a g m e n t s |
aloud	 a l o u d |
typhoid	 t y p h o i d |
automaton	 a u t o m a t o n |
sent	 s e n t |
chill	 c h i l l |
through	 t h r o u g h |
best	 b e s t |
necessary	 n e c e s s a r y |
accessories	 a c c e s s o r i e s |
making	 m a k i n g |
shop	 s h o p |
ruth	 r u t h |
charged	 c h a r g e d |
him	 h i m |
excuse	 e x c u s e |
feelings	 f e e l i n g s |
aroused	 a r o u s e d |
rendezvous	 r e n d e z v o u s |
those	 t h o s e |
striving	 s t r i v i n g |
work	 w o r k |
ruin	 r u i n |
genuine	 g e n u i n e |
sympathy	 s y m p a t h y |
pierre	 p i e r r e |
obeys	 o b e y s |
turning	 t u r n i n g |
shoreward	 s h o r e w a r d |
right	 r i g h t |
foot	 f o o t |
feels	 f e e l s |
chinese	 c h i n e s e |
debutante	 d e b u t a n t e |
shorter	 s h o r t e r |
than	 t h a n |
companion	 c o m p a n i o n |
delicate	 d e l i c a t e |
physique	 p h y s i q u e |
dinner	 d i n n e r |
hours	 h o u r s |
years	 y e a r s |
ago	 a g o |
civilization	 c i v i l i z a t i o n |
died	 d i e d |
cold	 c o l d |
starvation	 s t a r v a t i o n |
singing	 s i n g i n g |
softly	 s o f t l y |
over	 o v e r |
rocks	 r o c k s |
determined	 d e t e r m i n e d |
maintain	 m a i n t a i n |
certain	 c e r t a i n |
hold	 h o l d |
became	 b e c a m e |
vital	 v i t a l |
part	 p a r t |
temptation	 t e m p t a t i o n |
resisted	 r e s i s t e d |
hope	 h o p e |
destroyed	 d e s t r o y e d |
quickly	 q u i c k l y |
born	 b o r n |
against	 a g a i n s t |
breast	 b r e a s t |
forever	 f o r e v e r |
business	 b u s i n e s s |
phil	 p h i l |
exclaimed	 e x c l a i m e d |
providence	 p r o v i d e n c e |
delivered	 d e l i v e r e d |
maelstrom	 m a e l s t r o m |
cry	 c r y |
joy	 j o y |
philips	 p h i l i p s |
lips	 l i p s |
feel	 f e e l |
foolishly	 f o o l i s h l y |
overestimated	 o v e r e s t i m a t e d |
strength	 s t r e n g t h |
pressure	 p r e s s u r e |
surprise	 s u r p r i s e |
father	 f a t h e r |
go	 g o |
everywhere	 e v e r y w h e r e |
evidences	 e v i d e n c e s |
luxury	 l u x u r y |
age	 a g e |
stepped	 s t e p p e d |
low	 l o w |
picture	 p i c t u r e |
greater	 g r e a t e r |
resemblance	 r e s e m b l a n c e |
washed	 w a s h e d |
groomed	 g r o o m e d |
disheveled	 d i s h e v e l e d |
clothes	 c l o t h e s |
blessing	 b l e s s i n g |
aurora	 a u r o r a |
borealis	 b o r e a l i s |
seems	 s e e m s |
pointing	 p o i n t i n g |
god	 g o d |
things	 t h i n g s |
occurred	 o c c u r r e d |
before	 b e f o r e |
forgotten	 f o r g o t t e n |
something	 s o m e t h i n g |
even	 e v e n |
startling	 s t a r t l i n g |
careful	 c a r e f u l |
tear	 t e a r |
easily	 e a s i l y |
course	 c o u r s e |
uninteresting	 u n i n t e r e s t i n g |
continued	 c o n t i n u e d |
intoxicated	 i n t o x i c a t e d |
madness	 m a d n e s s |
struck	 s t r u c k |
dead	 d e a d |
within	 w i t h i n |
instant	 i n s t a n t |
drawn	 d r a w n |
silhouette	 s i l h o u e t t e |
sky	 s k y |
goodbye	 g o o d b y e |
shouted	 s h o u t e d |
theres	 t h e r e s |
fort	 f o r t |
churchill	 c h u r c h i l l |
rifleshot	 r i f l e s h o t |
ridge	 r i d g e |
asleep	 a s l e e p |
macdougall	 m a c d o u g a l l |
three	 t h r e e |
weeks	 w e e k s |
spare	 s p a r e |
entered	 e n t e r e d |
tapped	 t a p p e d |
forehead	 f o r e h e a d |
suspiciously	 s u s p i c i o u s l y |
stubby	 s t u b b y |
forefinger	 f o r e f i n g e r |
smoothshaven	 s m o o t h s h a v e n |
hair	 h a i r |
eyes	 e y e s |
black	 b l a c k |
wont	 w o n t |
draw	 d r a w |
gentlemen	 g e n t l e m e n |
fire	 f i r e |
burned	 b u r n e d |
thorpe	 t h o r p e |
worshiped	 w o r s h i p e d |
dante	 d a n t e |
beatrice	 b e a t r i c e |
does	 d o e s |
look	 l o o k |
good	 g o o d |
though	 t h o u g h |
drumming	 d r u m m i n g |
piano	 p i a n o |
want	 w a n t |
see	 s e e |
gang	 g a n g |
throw	 t h r o w |
dirt	 d i r t |
friendship	 f r i e n d s h i p |
belize	 b e l i z e |
turns	 t u r n s |
hatred	 h a t r e d |
jealousy	 j e a l o u s y |
their	 t h e i r |
foreman	 f o r e m a n |
grub	 g r u b |
thats	 t h a t s |
subforeman	 s u b f o r e m a n |
effort	 e f f o r t |
year	 y e a r |
revealed	 r e v e a l e d |
attack	 a t t a c k |
camp	 c a m p |
night	 n i g h t |
days	 d a y s |
learned	 l e a r n e d |
where	 w h e r e |
men	 m e n |
hiding	 h i d i n g |
near	 n e a r |
cabin	 c a b i n |
bush	 b u s h |
whipped	 w h i p p e d |
sting	 s t i n g |
suddenly	 s u d d e n l y |
stopped	 s t o p p e d |
none	 n o n e |
meeting	 m e e t i n g |
change	 c h a n g e |
bring	 b r i n g |
eileen	 e i l e e n |
outer	 o u t e r |
door	 d o o r |
slightly	 s l i g h t l y |
ajar	 a j a r |
date	 d a t e |
nearly	 n e a r l y |
presage	 p r e s a g e |
storm	 s t o r m |
swelling	 s w e l l i n g |
yearning	 y e a r n i n g |
scrap	 s c r a p |
thoroughly	 t h o r o u g h l y |
efficiently	 e f f i c i e n t l y |
mauled	 m a u l e d |
every	 e v e r y |
bone	 b o n e |
aged	 a g e d |
body	 b o d y |
seemed	 s e e m e d |
broken	 b r o k e n |
dislocated	 d i s l o c a t e d |
im	 i m |
lets	 l e t s |
say	 s a y |
prayers	 p r a y e r s |
followed	 f o l l o w e d |
line	 l i n e |
proposed	 p r o p o s e d |
railroad	 r a i l r o a d |
chances	 c h a n c e s |
cheer	 c h e e r |
give	 g i v e |
paw	 p a w |
yap	 y a p |
mercy	 m e r c y |
air	 a i r |
growing	 g r o w i n g |
chilly	 c h i l l y |
dont	 d o n t |
chewing	 c h e w i n g |
questions	 q u e s t i o n s |
vaguely	 v a g u e l y |
mind	 m i n d |
flash	 f l a s h |
launched	 l a u n c h e d |
feathered	 f e a t h e r e d |
mass	 m a s s |
owl	 o w l |
ahead	 a h e a d |
glimmer	 g l i m m e r |
sunshine	 s u n s h i n e |
gigantic	 g i g a n t i c |
owls	 o w l s |
tearing	 t e a r i n g |
carcass	 c a r c a s s |
bigeyed	 b i g e y e d |
clucking	 c l u c k i n g |
moosebirds	 m o o s e b i r d s |
annoying	 a n n o y i n g |
canada	 c a n a d a |
jays	 j a y s |
persistent	 p e r s i s t e n t |
clubs	 c l u b s |
balls	 b a l l s |
cities	 c i t i e s |
memories	 m e m o r i e s |
exciting	 e x c i t i n g |
thrill	 t h r i l l |
rush	 r u s h |
edged	 e d g e d |
ice	 i c e |
drank	 d r a n k |
cautiously	 c a u t i o u s l y |
happened	 h a p p e n e d |
footprints	 f o o t p r i n t s |
wise	 w i s e |
driver	 d r i v e r |
kills	 k i l l s |
loose	 l o o s e |
sometimes	 s o m e t i m e s |
dreams	 d r e a m s |
filled	 f i l l e d |
visions	 v i s i o n s |
wilderness	 w i l d e r n e s s |
prepared	 p r e p a r e d |
leapt	 l e a p t |
club	 c l u b |
caught	 c a u g h t |
once	 o n c e |
twentieth	 t w e n t i e t h |
evening	 e v e n i n g |
shook	 s h o o k |
fairly	 f a i r l y |
clubbed	 c l u b b e d |
recognizing	 r e c o g n i z i n g |
cried	 c r i e d |
swung	 s w u n g |
wildly	 w i l d l y |
fearing	 f e a r i n g |
jacques	 j a c q u e s |
following	 f o l l o w i n g |
lake	 l a k e |
wolfdog	 w o l f d o g |
gaunt	 g a u n t |
muzzle	 m u z z l e |
toward	 t o w a r d |
pals	 p a l s |
says	 s a y s |
bought	 b o u g h t |
le	 l e |
beau	 b e a u |
youth	 y o u t h |
freed	 f r e e d |
yoke	 y o k e |
oppression	 o p p r e s s i o n |
round	 r o u n d |
diameter	 d i a m e t e r |
hundred	 h u n d r e d |
yards	 y a r d s |
hardly	 h a r d l y |
plans	 p l a n s |
public	 p u b l i c |
met	 m e t |
powerful	 p o w e r f u l |
opposition	 o p p o s i t i o n |
drowned	 d r o w n e d |
sound	 s o u n d |
brute	 b r u t e |
agony	 a g o n y |
death	 d e a t h |
cases	 c a s e s |
still	 s t i l l |
able	 a b l e |
clustered	 c l u s t e r e d |
spokesman	 s p o k e s m a n |
between	 b e t w e e n |
canegrass	 c a n e g r a s s |
fence	 f e n c e |
compound	 c o m p o u n d |
besides	 b e s i d e s |
tobacco	 t o b a c c o |
per	 p e r |
die	 d i e |
spite	 s p i t e |
felt	 f e l t |
sudden	 s u d d e n |
wave	 w a v e |
irritation	 i r r i t a t i o n |
oppressive	 o p p r e s s i v e |
heat	 h e a t |
ringing	 r i n g i n g |
bell	 b e l l |
puzzled	 p u z z l e d |
untoward	 u n t o w a r d |
use	 u s e |
plantation	 p l a n t a t i o n |
combination	 c o m b i n a t i o n |
canadian	 c a n a d i a n |
capital	 c a p i t a l |
organized	 o r g a n i z e d |
petitioned	 p e t i t i o n e d |
same	 s a m e |
privileges	 p r i v i l e g e s |
here	 h e r e |
homesick	 h o m e s i c k |
soft	 s o f t |
moist	 m o i s t |
girls	 g i r l s |
hawaii	 h a w a i i |
b	 b |
cs	 c s |
revolvers	 r e v o l v e r s |
rifles	 r i f l e s |
contributed	 c o n t r i b u t e d |
smash	 s m a s h |
last	 l a s t |
overseer	 o v e r s e e r |
any	 a n y |
around	 a r o u n d |
reports	 r e p o r t s |
chiefly	 c h i e f l y |
induced	 i n d u c e d |
buy	 b u y |
resident	 r e s i d e n t |
commissioner	 c o m m i s s i o n e r |
australia	 a u s t r a l i a |
cannot	 c a n n o t |
allow	 a l l o w |
cant	 c a n t |
changed	 c h a n g e d |
annoy	 a n n o y |
average	 a v e r a g e |
review	 r e v i e w |
nauseating	 n a u s e a t i n g |
cod	 c o d |
liver	 l i v e r |
passionately	 p a s s i o n a t e l y |
rebellious	 r e b e l l i o u s |
hate	 h a t e |
hughie	 h u g h i e |
managing	 m a n a g i n g |
gallina	 g a l l i n a |
oakland	 o a k l a n d |
afternoon	 a f t e r n o o n |
dismay	 d i s m a y |
broke	 b r o k e |
hearty	 h e a r t y |
laughter	 l a u g h t e r |
wash	 w a s h |
cooler	 c o o l e r |
judgment	 j u d g m e n t |
prevailed	 p r e v a i l e d |
rolled	 r o l l e d |
quotations	 q u o t a t i o n s |
soul	 s o u l |
devotion	 d e v o t i o n |
employers	 e m p l o y e r s |
aside	 a s i d e |
sixteen	 s i x t e e n |
lover	 l o v e r |
princess	 p r i n c e s s |
naomi	 n a o m i |
ought	 o u g h t |
pass	 p a s s |
today	 t o d a y |
however	 h o w e v e r |
staring	 s t a r i n g |
certitude	 c e r t i t u d e |
expectancy	 e x p e c t a n c y |
observed	 o b s e r v e d |
developed	 d e v e l o p e d |
vaulting	 v a u l t i n g |
accounting	 a c c o u n t i n g |
manage	 m a n a g e |
freight	 f r e i g h t |
cargo	 c a r g o |
clean	 c l e a n |
living	 l i v i n g |
young	 y o u n g |
ideals	 i d e a l s |
lived	 l i v e d |
found	 f o u n d |
family	 f a m i l y |
patino	 p a t i n o |
straight	 s t r a i g h t |
swam	 s w a m |
heads	 h e a d s |
smaller	 s m a l l e r |
malnutrition	 m a l n u t r i t i o n |
length	 l e n g t h |
elongated	 e l o n g a t e d |
neck	 n e c k |
ashore	 a s h o r e |
whoever	 w h o e v e r |
soaked	 s o a k e d |
seawater	 s e a w a t e r |
offset	 o f f s e t |
rays	 r a y s |
investing	 i n v e s t i n g |
nobody	 n o b o d y |
junta	 j u n t a |
least	 l e a s t |
show	 s h o w |
actual	 a c t u a l |
enthusiasm	 e n t h u s i a s m |
favor	 f a v o r |
doubly	 d o u b l y |
baptized	 b a p t i z e d |
sweeping	 s w e e p i n g |
vessel	 v e s s e l |
martha	 m a r t h a |
joan	 j o a n |
looked	 l o o k e d |
triumphantly	 t r i u m p h a n t l y |
sheldon	 s h e l d o n |
youve	 y o u v e |
plenty	 p l e n t y |
chain	 c h a i n |
discovery	 d i s c o v e r y |
spur	 s p u r |
handled	 h a n d l e d |
both	 b o t h |
grubthieves	 g r u b t h i e v e s |
eli	 e l i |
harding	 h a r d i n g |
asked	 a s k e d |
shunk	 s h u n k |
started	 s t a r t e d |
straightforward	 s t r a i g h t f o r w a r d |
cut	 c u t |
scottish	 s c o t t i s h |
chiefs	 c h i e f s |
killed	 k i l l e d |
bath	 b a t h |
shave	 s h a v e |
bad	 b a d |
robbery	 r o b b e r y |
bribery	 b r i b e r y |
fraud	 f r a u d |
please	 p l e a s e |
plain	 p l a i n |
statement	 s t a t e m e n t |
pay	 p a y |
trees	 t r e e s |
require	 r e q u i r e |
room	 r o o m |
raoul	 r a o u l |
listened	 l i s t e n e d |
tale	 t a l e |
house	 h o u s e |
kiddies	 k i d d i e s |
grown	 g r o w n |
youths	 y o u t h s |
oolong	 o o l o n g |
atoll	 a t o l l |
forty	 f o r t y |
miles	 m i l e s |
circumference	 c i r c u m f e r e n c e |
mccoy	 m c c o y |
stifling	 s t i f l i n g |
poisonous	 p o i s o n o u s |
atmosphere	 a t m o s p h e r e |
pent	 p e n t |
nervous	 n e r v o u s |
prostration	 p r o s t r a t i o n |
teeth	 t e e t h |
fifteen	 f i f t e e n |
minutes	 m i n u t e s |
forces	 f o r c e s |
moving	 m o v i n g |
country	 c o u n t r y |
blame	 b l a m e |
anything	 a n y t h i n g |
mean	 m e a n |
insinuate	 i n s i n u a t e |
brentwood	 b r e n t w o o d |
hotly	 h o t l y |
woman	 w o m a n |
incidental	 i n c i d e n t a l |
accidental	 a c c i d e n t a l |
irrelevant	 i r r e l e v a n t |
forecasting	 f o r e c a s t i n g |
processes	 p r o c e s s e s |
toothbrush	 t o o t h b r u s h |
imagine	 i m a g i n e |
choice	 c h o i c e |
fine	 f i n e |
official	 o f f i c i a l |
whipping	 w h i p p i n g |
oysters	 o y s t e r s |
oyster	 o y s t e r |
pirates	 p i r a t e s |
nicholas	 n i c h o l a s |
boys	 b o y s |
captured	 c a p t u r e d |
faith	 f a i t h |
overt	 o v e r t |
acts	 a c t s |
attempted	 a t t e m p t e d |
midmorning	 m i d m o r n i n g |
casualty	 c a s u a l t y |
deep	 d e e p |
primeval	 p r i m e v a l |
forest	 f o r e s t |
foiled	 f o i l e d |
attempt	 a t t e m p t |
twenty	 t w e n t y |
spears	 s p e a r s |
arrows	 a r r o w s |
bassett	 b a s s e t t |
fastidious	 f a s t i d i o u s |
english	 e n g l i s h |
general	 g e n e r a l |
whose	 w h o s e |
name	 n a m e |
roberts	 r o b e r t s |
tacit	 t a c i t |
acquaintance	 a c q u a i n t a n c e |
saxon	 s a x o n |
joythrill	 j o y t h r i l l |
disgusted	 d i s g u s t e d |
tomfoolery	 t o m f o o l e r y |
rot	 r o t |
earliest	 e a r l i e s t |
recollection	 r e c o l l e c t i o n |
sleep	 s l e e p |
period	 p e r i o d |
terror	 t e r r o r |
glad	 g l a d |
apart	 a p a r t |
violated	 v i o l a t e d |
plausible	 p l a u s i b l e |
convincing	 c o n v i n c i n g |
make	 m a k e |
mistake	 m i s t a k e |
ignoring	 i g n o r i n g |
duality	 d u a l i t y |
graduated	 g r a d u a t e d |
fixed	 f i x e d |
values	 v a l u e s |
altered	 a l t e r e d |
adjectives	 a d j e c t i v e s |
adverbs	 a d v e r b s |
pressing	 p r e s s i n g |
limits	 l i m i t s |
vocabulary	 v o c a b u l a r y |
separated	 s e p a r a t e d |
mother	 m o t h e r |
infernal	 i n f e r n a l |
worries	 w o r r i e s |
white	 w h i t e |
leghorns	 l e g h o r n s |
mrs	 m r s |
mortimer	 m o r t i m e r |
massage	 m a s s a g e |
tension	 t e n s i o n |
cryptic	 c r y p t i c |
reply	 r e p l y |
since	 s i n c e |
mysterious	 m y s t e r i o u s |
force	 f o r c e |
fighting	 f i g h t i n g |
step	 s t e p |
perpetual	 p e r p e t u a l |
apprehension	 a p p r e h e n s i o n |
quarter	 q u a r t e r |
compass	 c o m p a s s |
brokentooth	 b r o k e n t o o t h |
yelled	 y e l l e d |
fright	 f r i g h t |
momentum	 m o m e n t u m |
gained	 g a i n e d |
younger	 y o u n g e r |
waited	 w a i t e d |
billy	 b i l l y |
chased	 c h a s e d |
hyena	 h y e n a |
production	 p r o d u c t i o n |
doubling	 d o u b l i n g |
quadrupling	 q u a d r u p l i n g |
itself	 i t s e l f |
edinburgh	 e d i n b u r g h |
editorial	 e d i t o r i a l |
gloom	 g l o o m |
slammed	 s l a m m e d |
full	 f u l l |
redeyes	 r e d e y e s |
unfolded	 u n f o l d e d |
typewritten	 t y p e w r i t t e n |
letter	 l e t t e r |
handed	 h a n d e d |
log	 l o g |
lopear	 l o p e a r |
lying	 l y i n g |
adrift	 a d r i f t |
common	 c o m m o n |
experience	 e x p e r i e n c e |
considered	 c o n s i d e r e d |
victory	 v i c t o r y |
forward	 f o r w a r d |
meat	 m e a t |
forego	 f o r e g o |
revenge	 r e v e n g e |
whizzipbang	 w h i z z i p b a n g |
screamed	 s c r e a m e d |
anguish	 a n g u i s h |
cherokee	 c h e r o k e e |
identified	 i d e n t i f i e d |
instinct	 i n s t i n c t |
less	 l e s s |
stooped	 s t o o p e d |
springy	 s p r i n g y |
movements	 m o v e m e n t s |
caves	 c a v e s |
indeed	 i n d e e d |
redeye	 r e d e y e |
committed	 c o m m i t t e d |
outrageous	 o u t r a g e o u s |
deed	 d e e d |
seldens	 s e l d e n s |
stamp	 s t a m p |
stop	 s t o p |
women	 w o m e n |
poor	 p o o r |
crookedleg	 c r o o k e d l e g |
terribly	 t e r r i b l y |
scared	 s c a r e d |
unconsciously	 u n c o n s c i o u s l y |
yells	 y e l l s |
exclamations	 e x c l a m a t i o n s |
yielded	 y i e l d e d |
rhythm	 r h y t h m |
hell	 h e l l |
knock	 k n o c k |
sticks	 s t i c k s |
unexpected	 u n e x p e c t e d |
charge	 c h a r g e |
knocked	 k n o c k e d |
encouraged	 e n c o u r a g e d |
conduct	 c o n d u c t |
bigface	 b i g f a c e |
intermittent	 i n t e r m i t t e n t |
commands	 c o m m a n d s |
beating	 b e a t i n g |
hoofs	 h o o f s |
horrified	 h o r r i f i e d |
question	 q u e s t i o n |
doggone	 d o g g o n e |
shake	 s h a k e |
seventeen	 s e v e n t e e n |
state	 s t a t e |
alberta	 a l b e r t a |
fill	 f i l l |
tremendous	 t r e m e n d o u s |
trying	 t r y i n g |
apron	 a p r o n |
string	 s t r i n g |
get	 g e t |
dig	 d i g |
greatly	 g r e a t l y |
delighted	 d e l i g h t e d |
bright	 b r i g h t |
giveth	 g i v e t h |
lifted	 l i f t e d |
seven	 s e v e n |
fifty	 f i f t y |
simple	 s i m p l e |
pat	 p a t |
hanrahans	 h a n r a h a n s |
mug	 m u g |
willing	 w i l l i n g |
hotel	 h o t e l |
sugar	 s u g a r |
elijah	 e l i j a h |
explosion	 e x p l o s i o n |
mirth	 m i r t h |
failed	 f a i l e d |
obtain	 o b t a i n |
catch	 c a t c h |
foolishness	 f o o l i s h n e s s |
month	 m o n t h |
passed	 p a s s e d |
bonanza	 b o n a n z a |
creek	 c r e e k |
remained	 r e m a i n e d |
quiet	 q u i e t |
lie	 l i e |
outrun	 o u t r u n |
gravel	 g r a v e l |
pan	 p a n |
longer	 l o n g e r |
cared	 c a r e d |
quite	 q u i t e |
diversion	 d i v e r s i o n |
sitting	 s i t t i n g |
broach	 b r o a c h |
preferring	 p r e f e r r i n g |
mature	 m a t u r e |
carefully	 c a r e f u l l y |
nope	 n o p e |
slightest	 s l i g h t e s t |
market	 m a r k e t |
yet	 y e t |
during	 d u r i n g |
week	 w e e k |
preceding	 p r e c e d i n g |
thursday	 t h u r s d a y |
iota	 i o t a |
certainly	 c e r t a i n l y |
appreciate	 a p p r e c i a t e |
being	 b e i n g |
express	 e x p r e s s |
partnership	 p a r t n e r s h i p |
daylight	 d a y l i g h t |
pair	 p a i r |
raided	 r a i d e d |
san	 s a n |
jose	 j o s e |
interurban	 i n t e r u r b a n |
game	 g a m e |
doing	 d o i n g |
issued	 i s s u e d |
rate	 r a t e |
dollars	 d o l l a r s |
car	 c a r |
charcoal	 c h a r c o a l |
effect	 e f f e c t |
sketchy	 s k e t c h y |
points	 p o i n t s |
view	 v i e w |
ideas	 i d e a s |
lifes	 l i f e s |
cash	 c a s h |
argued	 a r g u e d |
butchers	 b u t c h e r s |
cutters	 c u t t e r s |
refused	 r e f u s e d |
handle	 h a n d l e |
destined	 d e s t i n e d |
unfair	 u n f a i r |
restaurants	 r e s t a u r a n t s |
price	 p r i c e |
son	 s o n |
disturb	 d i s t u r b |
hush	 h u s h |
awe	 a w e |
boundaries	 b o u n d a r i e s |
gouged	 g o u g e d |
jagged	 j a g g e d |
daddy	 d a d d y |
canyons	 c a n y o n s |
plentiful	 p l e n t i f u l |
luxuriant	 l u x u r i a n t |
growth	 g r o w t h |
ship	 s h i p |
ten	 t e n |
names	 n a m e s |
ferguson	 f e r g u s o n |
charmed	 c h a r m e d |
curious	 c u r i o u s |
answer	 a n s w e r |
flat	 f l a t |
uncompromising	 u n c o m p r o m i s i n g |
farmer	 f a r m e r |
works	 w o r k s |
produces	 p r o d u c e s |
grain	 g r a i n |
carnegie	 c a r n e g i e |
argue	 a r g u e |
bob	 b o b |
mab	 m a b |
tee	 t e e |
wonder	 w o n d e r |
reconciled	 r e c o n c i l e d |
act	 a c t |
magnificent	 m a g n i f i c e n t |
eating	 e a t i n g |
stable	 s t a b l e |
begun	 b e g u n |
borrowing	 b o r r o w i n g |
banks	 b a n k s |
strap	 s t r a p |
hangers	 h a n g e r s |
thatll	 t h a t l l |
werent	 w e r e n t |
street	 s t r e e t |
railway	 r a i l w a y |
earnings	 e a r n i n g s |
increasing	 i n c r e a s i n g |
steadily	 s t e a d i l y |
fat	 f a t |
submerged	 s u b m e r g e d |
call	 c a l l |
murmured	 m u r m u r e d |
ecstatically	 e c s t a t i c a l l y |
unwin	 u n w i n |
harrison	 h a r r i s o n |
while	 w h i l e |
jones	 j o n e s |
sat	 s a t |
chauffeur	 c h a u f f e u r |
heres	 h e r e s |
another	 a n o t h e r |
manuel	 m a n u e l |
besetting	 b e s e t t i n g |
sin	 s i n |
forget	 f o r g e t |
meanwhile	 m e a n w h i l e |
breathe	 b r e a t h e |
spell	 s p e l l |
smiled	 s m i l e d |
grimly	 g r i m l y |
hatchet	 h a t c h e t |
curly	 c u r l y |
rushed	 r u s h e d |
antagonist	 a n t a g o n i s t |
leaped	 l e a p e d |
newborn	 n e w b o r n |
cunning	 c u n n i n g |
poise	 p o i s e |
control	 c o n t r o l |
perrault	 p e r r a u l t |
buried	 b u r i e d |
box	 b o x |
ordained	 o r d a i n e d |
order	 o r d e r |
dogs	 d o g s |
francois	 f r a n c o i s |
mercedes	 m e r c e d e s |
laughed	 l a u g h e d |
manifested	 m a n i f e s t e d |
chaotic	 c h a o t i c |
abandonment	 a b a n d o n m e n t |
hysteria	 h y s t e r i a |
eldorado	 e l d o r a d o |
emptied	 e m p t i e d |
occupants	 o c c u p a n t s |
test	 t e s t |
fit	 f i t |
boat	 b o a t |
throughout	 t h r o u g h o u t |
lamps	 l a m p s |
explain	 e x p l a i n |
possession	 p o s s e s s i o n |
sketch	 s k e t c h |
break	 b r e a k |
hearts	 h e a r t s |
backs	 b a c k s |
anchor	 a n c h o r |
bulkheads	 b u l k h e a d s |
figuring	 f i g u r i n g |
lasted	 l a s t e d |
deterrent	 d e t e r r e n t |
weight	 w e i g h t |
velocity	 v e l o c i t y |
insidious	 i n s i d i o u s |
deceitful	 d e c e i t f u l |
sun	 s u n |
portuguese	 p o r t u g u e s e |
crawled	 c r a w l e d |
nearer	 n e a r e r |
hawaiian	 h a w a i i a n |
waving	 w a v i n g |
hat	 h a t |
murmuring	 m u r m u r i n g |
talked	 t a l k e d |
golly	 g o l l y |
wins	 w i n s |
halfway	 h a l f w a y |
track	 t r a c k |
donkey	 d o n k e y |
argument	 a r g u m e n t |
rider	 r i d e r |
mcveigh	 m c v e i g h |
returns	 r e t u r n s |
trip	 t r i p |
honolulu	 h o n o l u l u |
obviously	 o b v i o u s l y |
disease	 d i s e a s e |
contracted	 c o n t r a c t e d |
contact	 c o n t a c t |
otherwise	 o t h e r w i s e |
restriction	 r e s t r i c t i o n |
put	 p u t |
seafaring	 s e a f a r i n g |
incubation	 i n c u b a t i o n |
enters	 e n t e r s |
situation	 s i t u a t i o n |
exactly	 e x a c t l y |
deportation	 d e p o r t a t i o n |
quick	 q u i c k |
disappointment	 d i s a p p o i n t m e n t |
acquiescence	 a c q u i e s c e n c e |
nevertheless	 n e v e r t h e l e s s |
seat	 s e a t |
abundance	 a b u n d a n c e |
betrayal	 b e t r a y a l |
herself	 h e r s e l f |
tonic	 t o n i c |
wada	 w a d a |
nakata	 n a k a t a |
funk	 f u n k |
lost	 l o s t |
bridge	 b r i d g e |
tambo	 t a m b o |
native	 n a t i v e |
taboo	 t a b o o |
martin	 m a r t i n |
superior	 s u p e r i o r |
smile	 s m i l e |
professional	 p r o f e s s i o n a l |
medical	 m e d i c a l |
prestige	 p r e s t i g e |
stood	 s t o o d |
fell	 f e l l |
sea	 s e a |
monday	 m o n d a y |
march	 m a r c h |
16	 1 6 |
1908	 1 9 0 8 |
wednesday	 w e d n e s d a y |
18	 1 8 |
yes	 y e s |
corrected	 c o r r e c t e d |
quietly	 q u i e t l y |
violent	 v i o l e n t |
sports	 s p o r t s |
appealed	 a p p e a l e d |
live	 l i v e |
income	 i n c o m e |
altruism	 a l t r u i s m |
creative	 c r e a t i v e |
deluged	 d e l u g e d |
overwhelmed	 o v e r w h e l m e d |
dark	 d a r k |
darker	 d a r k e r |
hump	 h u m p |
schooner	 s c h o o n e r |
ghost	 g h o s t |
sinewy	 s i n e w y |
dripping	 d r i p p i n g |
clutching	 c l u t c h i n g |
rail	 r a i l |
seal	 s e a l |
girl	 g i r l |
faced	 f a c e d |
shining	 s h i n i n g |
fear	 f e a r |
blood	 b l o o d |
spouting	 s p o u t i n g |
kerfoots	 k e r f o o t s |
oilers	 o i l e r s |
fourth	 f o u r t h |
engineer	 e n g i n e e r |
greeting	 g r e e t i n g |
calculated	 c a l c u l a t e d |
sharp	 s h a r p |
minute	 m i n u t e |
later	 l a t e r |
easy	 e a s y |
stout	 s t o u t |
wood	 w o o d |
crushed	 c r u s h e d |
eggshell	 e g g s h e l l |
schoolboy	 s c h o o l b o y |
close	 c l o s e |
beside	 b e s i d e |
gleamed	 g l e a m e d |
fangs	 f a n g s |
wind	 w i n d |
tongue	 t o n g u e |
makes	 m a k e s |
knowledge	 k n o w l e d g e |
articulate	 a r t i c u l a t e |
cascades	 c a s c a d e s |
streaks	 s t r e a k s |
rust	 r u s t |
showed	 s h o w e d |
tap	 t a p |
whole	 w h o l e |
voyage	 v o y a g e |
west	 w e s t |
human	 h u m a n |
curry	 c u r r y |
sheer	 s h e e r |
genius	 g e n i u s |
eastern	 e a s t e r n |
heavens	 h e a v e n s |
equally	 e q u a l l y |
spat	 s p a t |
venom	 v e n o m |
handkerchief	 h a n d k e r c h i e f |
closely	 c l o s e l y |
mr	 m r |
pike	 p i k e |
nod	 n o d |
sarcastically	 s a r c a s t i c a l l y |
keenly	 k e e n l y |
intelligent	 i n t e l l i g e n t |
sharply	 s h a r p l y |
sensitive	 s e n s i t i v e |
successfully	 s u c c e s s f u l l y |
calm	 c a l m |
snowy	 s n o w y |
sailed	 s a i l e d |
third	 t h i r d |
mate	 m a t e |
vampire	 v a m p i r e |
outstretched	 o u t s t r e t c h e d |
dropped	 d r o p p e d |
side	 s i d e |
paused	 p a u s e d |
shoulder	 s h o u l d e r |
louis	 l o u i s |
servants	 s e r v a n t s |
breed	 b r e e d |
forbidden	 f o r b i d d e n |
smoking	 s m o k i n g |
pipes	 p i p e s |
afterroom	 a f t e r r o o m |
tried	 t r i e d |
george	 g e o r g e |
moore	 m o o r e |
dreadfully	 d r e a d f u l l y |
bored	 b o r e d |
spink	 s p i n k |
harpoon	 h a r p o o n |
reentered	 r e e n t e r e d |
nimrod	 n i m r o d |
slight	 s l i g h t |
manifestation	 m a n i f e s t a t i o n |
sensitiveness	 s e n s i t i v e n e s s |
chief	 c h i e f |
lies	 l i e s |
wear	 w e a r |
dispute	 d i s p u t e |
corry	 c o r r y |
hutchinson	 h u t c h i n s o n |
married	 m a r r i e d |
mabel	 m a b e l |
holmes	 h o l m e s |
nosiree	 n o s i r e e |
insult	 i n s u l t |
claim	 c l a i m |
rest	 r e s t |
mere	 m e r e |
river	 r i v e r |
bared	 b a r e d |
bosom	 b o s o m |
snorting	 s n o r t i n g |
steamboats	 s t e a m b o a t s |
brightness	 b r i g h t n e s s |
artists	 a r t i s t s |
johnny	 j o h n n y |
shuffled	 s h u f f l e d |
walked	 w a l k e d |
absurdity	 a b s u r d i t y |
affected	 a f f e c t e d |
curiously	 c u r i o u s l y |
denial	 d e n i a l |
guilt	 g u i l t |
onelegged	 o n e l e g g e d |
burnt	 b u r n t |
crater	 c r a t e r |
volcano	 v o l c a n o |
specially	 s p e c i a l l y |
maltreated	 m a l t r e a t e d |
coat	 c o a t |
bore	 b o r e |
grudges	 g r u d g e s |
enemies	 e n e m i e s |
king	 k i n g |
patiently	 p a t i e n t l y |
lines	 l i n e s |
taut	 t a u t |
judge	 j u d g e |
jury	 j u r y |
bless	 b l e s s |
em	 e m |
seeing	 s e e i n g |
lace	 l a c e |
ivory	 i v o r y |
color	 c o l o r |
faintly	 f a i n t l y |
tinted	 t i n t e d |
joking	 j o k i n g |
managed	 m a n a g e d |
unusual	 u n u s u a l |
sufficient	 s u f f i c i e n t |
send	 s e n d |
molokai	 m o l o k a i |
beady	 b e a d y |
bargains	 b a r g a i n s |
bankruptcy	 b a n k r u p t c y |
athlete	 a t h l e t e |
fished	 f i s h e d |
sharks	 s h a r k s |
niihau	 n i i h a u |
claudine	 c l a u d i n e |
leaving	 l e a v i n g |
morning	 m o r n i n g |
short	 s h o r t |
joyous	 j o y o u s |
individualism	 i n d i v i d u a l i s m |
dominated	 d o m i n a t e d |
orthodox	 o r t h o d o x |
bourgeois	 b o u r g e o i s |
ethics	 e t h i c s |
humanity	 h u m a n i t y |
accordance	 a c c o r d a n c e |
ernests	 e r n e s t s |
worked	 w o r k e d |
themselves	 t h e m s e l v e s |
disillusionment	 d i s i l l u s i o n m e n t |
coincidence	 c o i n c i d e n c e |
behind	 b e h i n d |
university	 u n i v e r s i t y |
ideal	 i d e a l |
palace	 p a l a c e |
wherein	 w h e r e i n |
money	 m o n e y |
alone	 a l o n e |
consumed	 c o n s u m e d |
fleshpots	 f l e s h p o t s |
amongst	 a m o n g s t |
speak	 s p e a k |
conjured	 c o n j u r e d |
illuminating	 i l l u m i n a t i n g |
becoming	 b e c o m i n g |
profit	 p r o f i t |
direct	 d i r e c t |
laws	 l a w s |
fond	 f o n d |
quoting	 q u o t i n g |
fragment	 f r a g m e n t |
poem	 p o e m |
fingers	 f i n g e r s |
closed	 c l o s e d |
tightly	 t i g h t l y |
method	 m e t h o d |
producing	 p r o d u c i n g |
surpluses	 s u r p l u s e s |
instituted	 i n s t i t u t e d |
dozen	 d o z e n |
cooperative	 c o o p e r a t i v e |
commonwealth	 c o m m o n w e a l t h |
states	 s t a t e s |
wanted	 w a n t e d |
violence	 v i o l e n c e |
appear	 a p p e a r |
lush	 l u s h |
sheltered	 s h e l t e r e d |
spot	 s p o t |
natural	 n a t u r a l |
shield	 s h i e l d |
message	 m e s s a g e |
rapidly	 r a p i d l y |
ask	 a s k |
pasquini	 p a s q u i n i |
rock	 r o c k |
bucolic	 b u c o l i c |
school	 s c h o o l |
taught	 t a u g h t |
imagining	 i m a g i n i n g |
drought	 d r o u g h t |
destroy	 d e s t r o y |
crops	 c r o p s |
dunham	 d u n h a m |
jesse	 j e s s e |
johannes	 j o h a n n e s |
preacher	 p r e a c h e r |
doctrine	 d o c t r i n e |
enthusiast	 e n t h u s i a s t |
desert	 d e s e r t |
dweller	 d w e l l e r |
pascal	 p a s c a l |
glimpsed	 g l i m p s e d |
seer	 s e e r |
engage	 e n g a g e |
lesser	 l e s s e r |
animals	 a n i m a l s |
undecided	 u n d e c i d e d |
strained	 s t r a i n e d |
warden	 w a r d e n |
quart	 q u a r t |
champagne	 c h a m p a g n e |
doubt	 d o u b t |
engagements	 e n g a g e m e n t s |
organic	 o r g a n i c |
chemical	 c h e m i c a l |
predisposition	 p r e d i s p o s i t i o n |
alcohol	 a l c o h o l |
anticipate	 a n t i c i p a t e |
bachelor	 b a c h e l o r |
establishment	 e s t a b l i s h m e n t |
balance	 b a l a n c e |
pitched	 p i t c h e d |
foremost	 f o r e m o s t |
ooze	 o o z e |
dated	 d a t e d |
drunk	 d r u n k |
churches	 c h u r c h e s |
preachers	 p r e a c h e r s |
known	 k n o w n |
weigh	 w e i g h |
pound	 p o u n d |
burn	 b u r n |
daily	 d a i l y |
schedule	 s c h e d u l e |
pearces	 p e a r c e s |
shrewdly	 s h r e w d l y |
appearance	 a p p e a r a n c e |
mirage	 m i r a g e |
immortal	 i m m o r t a l |
feebly	 f e e b l y |
writing	 w r i t i n g |
jack	 j a c k |
london	 l o n d o n |
waikiki	 w a i k i k i |
oahu	 o a h u |
jerry	 j e r r y |
secure	 s e c u r e |
nook	 n o o k |
roll	 r o l l |
hes	 h e s |
goods	 g o o d s |
refugee	 r e f u g e e |
foundation	 f o u n d a t i o n |
stone	 s t o n e |
service	 s e r v i c e |
obedience	 o b e d i e n c e |
unto	 u n t o |
grace	 g r a c e |
opened	 o p e n e d |
shaped	 s h a p e d |
vainly	 v a i n l y |
bill	 b i l l |
lingered	 l i n g e r e d |
contemplating	 c o n t e m p l a t i n g |
appreciation	 a p p r e c i a t i o n |
flaming	 f l a m i n g |
mcfees	 m c f e e s |
jaws	 j a w s |
snap	 s n a p |
womble	 w o m b l e |
announced	 a n n o u n c e d |
dennins	 d e n n i n s |
released	 r e l e a s e d |
sign	 s i g n |
document	 d o c u m e n t |
irvine	 i r v i n e |
impulse	 i m p u l s e |
poet	 p o e t |
bursting	 b u r s t i n g |
linderman	 l i n d e r m a n |
peterborough	 p e t e r b o r o u g h |
thousandyearslong	 t h o u s a n d y e a r s l o n g |
road	 r o a d |
across	 a c r o s s |
siberia	 s i b e r i a |
russia	 r u s s i a |
information	 i n f o r m a t i o n |
curiosity	 c u r i o s i t y |
else	 e l s e |
build	 b u i l d |
yukon	 y u k o n |
save	 s a v e |
saying	 s a y i n g |
missions	 m i s s i o n s |
persian	 p e r s i a n |
hers	 h e r s |
jews	 j e w s |
harp	 h a r p |
emitting	 e m i t t i n g |
barbaric	 b a r b a r i c |
rhythms	 r h y t h m s |
michael	 m i c h a e l |
helpless	 h e l p l e s s |
postpone	 p o s t p o n e |
emma	 e m m a |
louisa	 l o u i s a |
immaculate	 i m m a c u l a t e |
proposition	 p r o p o s i t i o n |
daughtrys	 d a u g h t r y s |
daughtry	 d a u g h t r y |
elaborated	 e l a b o r a t e d |
counting	 c o u n t i n g |
trick	 t r i c k |
bringing	 b r i n g i n g |
cocky	 c o c k y |
principally	 p r i n c i p a l l y |
stewards	 s t e w a r d s |
sake	 s a k e |
noted	 n o t e d |
thirst	 t h i r s t |
unquenchable	 u n q u e n c h a b l e |
lion	 l i o n |
charles	 c h a r l e s |
suggested	 s u g g e s t e d |
foolish	 f o o l i s h |
comparatively	 c o m p a r a t i v e l y |
advantages	 a d v a n t a g e s |
proved	 p r o v e d |
amateurish	 a m a t e u r i s h |
sophomoric	 s o p h o m o r i c |
productions	 p r o d u c t i o n s |
sick	 s i c k |
protege	 p r o t e g e |
anyway	 a n y w a y |
indigestion	 i n d i g e s t i o n |
find	 f i n d |
fault	 f a u l t |
shed	 s h e d |
wife	 w i f e |
cashier	 c a s h i e r |
gad	 g a d |
pretty	 p r e t t y |
knife	 k n i f e |
slim	 s l i m |
steel	 s t e e l |
seized	 s e i z e d |
led	 l e d |
hear	 h e a r |
indian	 i n d i a n |
wailing	 w a i l i n g |
superlative	 s u p e r l a t i v e |
degree	 d e g r e e |
snatched	 s n a t c h e d |
held	 h e l d |
burke	 b u r k e |
criticized	 c r i t i c i z e d |
because	 b e c a u s e |
id	 i d |
glorious	 g l o r i o u s |
map	 m a p |
finger	 f i n g e r |
companions	 c o m p a n i o n s |
thrilled	 t h r i l l e d |
lakes	 l a k e s |
rivers	 r i v e r s |
hundreds	 h u n d r e d s |
thousands	 t h o u s a n d s |
whitefish	 w h i t e f i s h |
trout	 t r o u t |
robbed	 r o b b e d |
chuckled	 c h u c k l e d |
pulled	 p u l l e d |
pipe	 p i p e |
filling	 f i l l i n g |
everything	 e v e r y t h i n g |
working	 w o r k i n g |
smoothly	 s m o o t h l y |
better	 b e t t e r |
expected	 e x p e c t e d |
stared	 s t a r e d |
others	 o t h e r s |
completely	 c o m p l e t e l y |
gripped	 g r i p p e d |
edges	 e d g e s |
table	 t a b l e |
believes	 b e l i e v e s |
understand	 u n d e r s t a n d |
associated	 a s s o c i a t e d |
chivalry	 c h i v a l r y |
shown	 s h o w n |
fight	 f i g h t |
stranger	 s t r a n g e r |
fitzhugh	 f i t z h u g h |
key	 k e y |
operations	 o p e r a t i o n s |
carried	 c a r r i e d |
montreal	 m o n t r e a l |
toronto	 t o r o n t o |
lighted	 l i g h t e d |
match	 m a t c h |
fingertips	 f i n g e r t i p s |
seated	 s e a t e d |
lamp	 l a m p |
sharpening	 s h a r p e n i n g |
pencil	 p e n c i l |
jerk	 j e r k |
wager	 w a g e r |
confessed	 c o n f e s s e d |
startled	 s t a r t l e d |
wondered	 w o n d e r e d |
roscoe	 r o s c o e |
developments	 d e v e l o p m e n t s |
haste	 h a s t e |
awaken	 a w a k e n |
tingling	 t i n g l i n g |
return	 r e t u r n |
elapsed	 e l a p s e d |
sale	 s a l e |
moments	 m o m e n t s |
silence	 s i l e n c e |
pursue	 p u r s u e |
subject	 s u b j e c t |
produced	 p r o d u c e d |
couple	 c o u p l e |
cigars	 c i g a r s |
opposite	 o p p o s i t e |
window	 w i n d o w |
cords	 c o r d s |
uncomfortable	 u n c o m f o r t a b l e |
except	 e x c e p t |
ink	 i n k |
blot	 b l o t |
sixth	 s i x t h |
spent	 s p e n t |
flush	 f l u s h |
rattled	 r a t t l e d |
understood	 u n d e r s t o o d |
meaning	 m e a n i n g |
beautiful	 b e a u t i f u l |
thousand	 t h o u s a n d |
produce	 p r o d u c e |
won	 w o n |
popular	 p o p u l a r |
sentiment	 s e n t i m e n t |
newspapers	 n e w s p a p e r s |
falter	 f a l t e r |
achieve	 a c h i e v e |
mental	 m e n t a l |
energy	 e n e r g y |
restless	 r e s t l e s s |
promised	 p r o m i s e d |
fascinate	 f a s c i n a t e |
challenge	 c h a l l e n g e |
presence	 p r e s e n c e |
missing	 m i s s i n g |
wall	 w a l l |
boiled	 b o i l e d |
coffee	 c o f f e e |
wait	 w a i t |
meet	 m e e t |
apologize	 a p o l o g i z e |
below	 b e l o w |
shadow	 s h a d o w |
pool	 p o o l |
rippling	 r i p p l i n g |
starlight	 s t a r l i g h t |
chance	 c h a n c e |
observe	 o b s e r v e |
incident	 i n c i d e n t |
hitting	 h i t t i n g |
hastened	 h a s t e n e d |
guided	 g u i d e d |
arguments	 a r g u m e n t s |
convinced	 c o n v i n c e d |
miss	 m i s s |
caution	 c a u t i o n |
recover	 r e c o v e r |
jeannes	 j e a n n e s |
guards	 g u a r d s |
nearest	 n e a r e s t |
refuge	 r e f u g e |
direction	 d i r e c t i o n |
pride	 p r i d e |
ring	 r i n g |
triumph	 t r i u m p h |
quivering	 q u i v e r i n g |
strong	 s t r o n g |
stand	 s t a n d |
leave	 l e a v e |
cursed	 c u r s e d |
tragedy	 t r a g e d y |
care	 c a r e |
search	 s e a r c h |
intention	 i n t e n t i o n |
done	 d o n e |
coils	 c o i l s |
narrowed	 n a r r o w e d |
current	 c u r r e n t |
swifter	 s w i f t e r |
progressed	 p r o g r e s s e d |
speaking	 s p e a k i n g |
darkness	 d a r k n e s s |
hid	 h i d |
consciousness	 c o n s c i o u s n e s s |
called	 c a l l e d |
noise	 n o i s e |
deaf	 d e a f |
hunt	 h u n t |
begin	 b e g i n |
crest	 c r e s t |
leaning	 l e a n i n g |
saving	 s a v i n g |
win	 w i n |
shooting	 s h o o t i n g |
pains	 p a i n s |
flashes	 f l a s h e s |
electricity	 e l e c t r i c i t y |
knows	 k n o w s |
object	 o b j e c t |
sensation	 s e n s a t i o n |
miracle	 m i r a c l e |
owe	 o w e |
lightly	 l i g h t l y |
ready	 r e a d y |
journey	 j o u r n e y |
dawn	 d a w n |
gazed	 g a z e d |
pathetic	 p a t h e t i c |
attitude	 a t t i t u d e |
position	 p o s i t i o n |
illusion	 i l l u s i o n |
word	 w o r d |
hunted	 h u n t e d |
thorpes	 t h o r p e s |
eileens	 e i l e e n s |
double	 d o u b l e |
light	 l i g h t |
billinger	 b i l l i n g e r |
arrive	 a r r i v e |
hitch	 h i t c h |
cigarette	 c i g a r e t t e |
neither	 n e i t h e r |
disaffection	 d i s a f f e c t i o n |
times	 t i m e s |
swear	 s w e a r |
oozing	 o o z i n g |
slowly	 s l o w l y |
mans	 m a n s |
belonged	 b e l o n g e d |
promoters	 p r o m o t e r s |
heavy	 h e a v y |
puffy	 p u f f y |
bags	 b a g s |
bent	 b e n t |
kill	 k i l l |
further	 f u r t h e r |
detail	 d e t a i l |
roar	 r o a r |
blind	 b l i n d |
rage	 r a g e |
darted	 d a r t e d |
measured	 m e a s u r e d |
defect	 d e f e c t |
worry	 w o r r y |
waiting	 w a i t i n g |
chew	 c h e w |
rabbit	 r a b b i t |
facing	 f a c i n g |
ambush	 a m b u s h |
pits	 p i t s |
vastly	 v a s t l y |
thrilling	 t h r i l l i n g |
reach	 r e a c h |
heart	 h e a r t |
simply	 s i m p l y |
squarely	 s q u a r e l y |
interrupted	 i n t e r r u p t e d |
poked	 p o k e d |
stick	 s t i c k |
thick	 t h i c k |
ground	 g r o u n d |
spruce	 s p r u c e |
pebbles	 p e b b l e s |
flew	 f l e w |
fur	 f u r |
foreboding	 f o r e b o d i n g |
fisher	 f i s h e r |
trap	 t r a p |
ow	 o w |
wild	 w i l d |
growled	 g r o w l e d |
pariah	 p a r i a h |
wanderer	 w a n d e r e r |
home	 h o m e |
freshly	 f r e s h l y |
furs	 f u r s |
flung	 f l u n g |
floor	 f l o o r |
chosen	 c h o s e n |
crib	 c r i b |
baby	 b a b y |
prattle	 p r a t t l e |
gray	 g r a y |
faltered	 f a l t e r e d |
deepened	 d e e p e n e d |
shrinking	 s h r i n k i n g |
arms	 a r m s |
shut	 s h u t |
click	 c l i c k |
spectators	 s p e c t a t o r s |
shudder	 s h u d d e r |
factors	 f a c t o r s |
shoulders	 s h o u l d e r s |
moon	 m o o n |
westward	 w e s t w a r d |
decline	 d e c l i n e |
happy	 h a p p y |
crashed	 c r a s h e d |
fast	 f a s t |
relief	 r e l i e f |
partly	 p a r t l y |
worship	 w o r s h i p |
warm	 w a r m |
drew	 d r e w |
breath	 b r e a t h |
steamer	 s t e a m e r |
reclining	 r e c l i n i n g |
corner	 c o r n e r |
hawk	 h a w k |
brooded	 b r o o d e d |
castor	 c a s t o r |
murder	 m u r d e r |
lust	 l u s t |
possessed	 p o s s e s s e d |
overflowing	 o v e r f l o w i n g |
glanced	 g l a n c e d |
thermometer	 t h e r m o m e t e r |
flashing	 f l a s h i n g |
supper	 s u p p e r |
fathom	 f a t h o m |
beg	 b e g |
pardon	 p a r d o n |
drawled	 d r a w l e d |
preferred	 p r e f e r r e d |
cannibal	 c a n n i b a l |
isle	 i s l e |
cartridge	 c a r t r i d g e |
belt	 b e l t |
fall	 f a l l |
thieves	 t h i e v e s |
brain	 b r a i n |
oaths	 o a t h s |
wrecked	 w r e c k e d |
godsend	 g o d s e n d |
elsewhere	 e l s e w h e r e |
account	 a c c o u n t |
achievements	 a c h i e v e m e n t s |
cocoanuts	 c o c o a n u t s |
revelation	 r e v e l a t i o n |
helplessly	 h e l p l e s s l y |
moistened	 m o i s t e n e d |
distinguishes	 d i s t i n g u i s h e s |
lower	 l o w e r |
idealism	 i d e a l i s m |
anarchy	 a n a r c h y |
threw	 t h r e w |
contended	 c o n t e n d e d |
established	 e s t a b l i s h e d |
carrying	 c a r r y i n g |
weapons	 w e a p o n s |
outsiders	 o u t s i d e r s |
allowed	 a l l o w e d |
five	 f i v e |
speeches	 s p e e c h e s |
urged	 u r g e d |
packards	 p a c k a r d s |
finish	 f i n i s h |
suicide	 s u i c i d e |
natives	 n a t i v e s |
planters	 p l a n t e r s |
considering	 c o n s i d e r i n g |
trouble	 t r o u b l e |
advisedly	 a d v i s e d l y |
dear	 d e a r |
second	 s e c o n d |
victim	 v i c t i m |
fallen	 f a l l e n |
eventuality	 e v e n t u a l i t y |
branch	 b r a n c h |
organizations	 o r g a n i z a t i o n s |
europe	 e u r o p e |
shaken	 s h a k e n |
foundations	 f o u n d a t i o n s |
perfume	 p e r f u m e |
weighted	 w e i g h t e d |
fluttered	 f l u t t e r e d |
fluffs	 f l u f f s |
cottonwoods	 c o t t o n w o o d s |
destroying	 d e s t r o y i n g |
horses	 h o r s e s |
toys	 t o y s |
nursery	 n u r s e r y |
todays	 t o d a y s |
paper	 p a p e r |
touchy	 t o u c h y |
wards	 w a r d s |
calls	 c a l l s |
whatever	 w h a t e v e r |
guessed	 g u e s s e d |
locked	 l o c k e d |
eighty	 e i g h t y |
maui	 m a u i |
property	 p r o p e r t y |
wish	 w i s h |
adaptable	 a d a p t a b l e |
passage	 p a s s a g e |
engaged	 e n g a g e d |
streaming	 s t r e a m i n g |
issue	 i s s u e |
harry	 h a r r y |
bancroft	 b a n c r o f t |
dave	 d a v e |
lied	 l i e d |
yankee	 y a n k e e |
leader	 l e a d e r |
tudor	 t u d o r |
lieutenant	 l i e u t e n a n t |
likewise	 l i k e w i s e |
disinclined	 d i s i n c l i n e d |
eaten	 e a t e n |
culture	 c u l t u r e |
exhausted	 e x h a u s t e d |
president	 p r e s i d e n t |
united	 u n i t e d |
personification	 p e r s o n i f i c a t i o n |
duplicity	 d u p l i c i t y |
shorty	 s h o r t y |
creeping	 c r e e p i n g |
pierres	 p i e r r e s |
splendid	 s p l e n d i d |
hurry	 h u r r y |
whats	 w h a t s |
grubthief	 g r u b t h i e f |
superb	 s u p e r b |
irate	 i r a t e |
skipper	 s k i p p e r |
dashed	 d a s h e d |
wet	 w e t |
parting	 p a r t i n g |
plugged	 p l u g g e d |
scarcely	 s c a r c e l y |
uttered	 u t t e r e d |
closing	 c l o s i n g |
shot	 s h o t |
open	 o p e n |
swim	 s w i m |
barked	 b a r k e d |
four	 f o u r |
valley	 v a l l e y |
japanese	 j a p a n e s e |
positively	 p o s i t i v e l y |
soulless	 s o u l l e s s |
savagely	 s a v a g e l y |
prospered	 p r o s p e r e d |
foe	 f o e |
trickle	 t r i c k l e |
lot	 l o t |
fish	 f i s h |
patrol	 p a t r o l |
charley	 c h a r l e y |
enraged	 e n r a g e d |
greek	 g r e e k |
swept	 s w e p t |
currents	 c u r r e n t s |
resembled	 r e s e m b l e d |
tea	 t e a |
lager	 l a g e r |
beer	 b e e r |
resembles	 r e s e m b l e s |
true	 t r u e |
discouraged	 d i s c o u r a g e d |
vagabonds	 v a g a b o n d s |
invaders	 i n v a d e r s |
irritating	 i r r i t a t i n g |
outwardly	 o u t w a r d l y |
maintained	 m a i n t a i n e d |
aspect	 a s p e c t |
surveyed	 s u r v e y e d |
withering	 w i t h e r i n g |
disgust	 d i s g u s t |
terrible	 t e r r i b l e |
suddenness	 s u d d e n n e s s |
fired	 f i r e d |
eight	 e i g h t |
hurt	 h u r t |
saxons	 s a x o n s |
onto	 o n t o |
job	 j o b |
confide	 c o n f i d e |
strangeness	 s t r a n g e n e s s |
rebelled	 r e b e l l e d |
yourself	 y o u r s e l f |
frowned	 f r o w n e d |
station	 s t a t i o n |
ferry	 f e r r y |
depot	 d e p o t |
stones	 s t o n e s |
casual	 c a s u a l |
helterskelter	 h e l t e r s k e l t e r |
sort	 s o r t |
merely	 m e r e l y |
inch	 i n c h |
source	 s o u r c e |
harsh	 h a r s h |
friends	 f r i e n d s |
folk	 f o l k |
magazine	 m a g a z i n e |
loaded	 l o a d e d |
resumed	 r e s u m e d |
paddling	 p a d d l i n g |
mockery	 m o c k e r y |
snarl	 s n a r l |
slid	 s l i d |
applauded	 a p p l a u d e d |
hall	 h a l l |
sooner	 s o o n e r |
book	 b o o k |
veins	 v e i n s |
doubtless	 d o u b t l e s s |
ruptured	 r u p t u r e d |
difficulty	 d i f f i c u l t y |
proceeded	 p r o c e e d e d |
dine	 d i n e |
auspicious	 a u s p i c i o u s |
devised	 d e v i s e d |
nightglow	 n i g h t g l o w |
treacherous	 t r e a c h e r o u s |
shoot	 s h o o t |
spend	 s p e n d |
progress	 p r o g r e s s |
slow	 s l o w |
erratic	 e r r a t i c |
placed	 p l a c e d |
accelerated	 a c c e l e r a t e d |
firemen	 f i r e m e n |
wore	 w o r e |
animal	 a n i m a l |
skins	 s k i n s |
waists	 w a i s t s |
domestic	 d o m e s t i c |
hostilities	 h o s t i l i t i e s |
watched	 w a t c h e d |
jock	 j o c k |
regret	 r e g r e t |
archibald	 a r c h i b a l d |
style	 s t y l e |
sponge	 s p o n g e |
approached	 a p p r o a c h e d |
clutched	 c l u t c h e d |
brodies	 b r o d i e s |
sarcastic	 s a r c a s t i c |
often	 o f t e n |
halfcock	 h a l f c o c k |
flying	 f l y i n g |
arrow	 a r r o w |
solicitors	 s o l i c i t o r s |
legal	 l e g a l |
previous	 p r e v i o u s |
wives	 w i v e s |
emerging	 e m e r g i n g |
swamp	 s w a m p |
cameron	 c a m e r o n |
vegetables	 v e g e t a b l e s |
fruits	 f r u i t s |
eaters	 e a t e r s |
playing	 p l a y i n g |
single	 s i n g l e |
looks	 l o o k s |
losing	 l o s i n g |
hot	 h o t |
migration	 m i g r a t i o n |
elam	 e l a m |
harnish	 h a r n i s h |
exception	 e x c e p t i o n |
treatment	 t r e a t m e n t |
doctor	 d o c t o r |
daylights	 d a y l i g h t s |
loomed	 l o o m e d |
shied	 s h i e d |
unbroken	 u n b r o k e n |
colt	 c o l t |
endowment	 e n d o w m e n t |
sole	 s o l e |
conversation	 c o n v e r s a t i o n |
meal	 m e a l |
flamed	 f l a m e d |
burning	 b u r n i n g |
midstream	 m i d s t r e a m |
searching	 s e a r c h i n g |
shadows	 s h a d o w s |
shores	 s h o r e s |
tired	 t i r e d |
profoundly	 p r o f o u n d l y |
provocative	 p r o v o c a t i v e |
arrived	 a r r i v e d |
supply	 s u p p l y |
crickets	 c r i c k e t s |
chirp	 c h i r p |
geese	 g e e s e |
ducks	 d u c k s |
overhead	 o v e r h e a d |
till	 t i l l |
inadequacy	 i n a d e q u a c y |
howison	 h o w i s o n |
crouched	 c r o u c h e d |
chairs	 c h a i r s |
commanded	 c o m m a n d e d |
chips	 c h i p s |
partners	 p a r t n e r s |
starved	 s t a r v e d |
stewart	 s t e w a r t |
dressed	 d r e s s e d |
audacious	 a u d a c i o u s |
oh	 o h |
novel	 n o v e l |
story	 s t o r y |
ranch	 r a n c h |
barely	 b a r e l y |
glow	 g l o w |
unobtrusive	 u n o b t r u s i v e |
plumb	 p l u m b |
gosh	 g o s h |
darned	 d a r n e d |
joys	 j o y s |
sources	 s o u r c e s |
play	 p l a y |
improvement	 i m p r o v e m e n t |
pump	 p u m p |
lots	 l o t s |
buggy	 b u g g y |
riding	 r i d i n g |
gaze	 g a z e |
returned	 r e t u r n e d |
venus	 v e n u s |
canvas	 c a n v a s |
tent	 t e n t |
satisfied	 s a t i s f i e d |
hundredth	 h u n d r e d t h |
tumbling	 t u m b l i n g |
butcher	 b u t c h e r |
baker	 b a k e r |
matthewson	 m a t t h e w s o n |
whos	 w h o s |
bookkeeper	 b o o k k e e p e r |
rogers	 r o g e r s |
possible	 p o s s i b l e |
junk	 j u n k |
proper	 p r o p e r |
division	 d i v i s i o n |
labor	 l a b o r |
individually	 i n d i v i d u a l l y |
performed	 p e r f o r m e d |
loved	 l o v e d |
lottery	 l o t t e r y |
fang	 f a n g |
perhaps	 p e r h a p s |
fate	 f a t e |
deeper	 d e e p e r |
temperature	 t e m p e r a t u r e |
zero	 z e r o |
obey	 o b e y |
comes	 c o m e s |
undue	 u n d u e |
prominence	 p r o m i n e n c e |
ego	 e g o |
canals	 c a n a l s |
china	 c h i n a |
yangtse	 y a n g t s e |
threaten	 t h r e a t e n |
completed	 c o m p l e t e d |
built	 b u i l t |
primarily	 p r i m a r i l y |
bohemian	 b o h e m i a n |
francisco	 f r a n c i s c o |
crack	 c r a c k |
sailors	 s a i l o r s |
forgot	 f o r g o t |
printed	 p r i n t e d |
page	 p a g e |
teach	 t e a c h |
arrange	 a r r a n g e |
comfortably	 c o m f o r t a b l y |
teaching	 t e a c h i n g |
behold	 b e h o l d |
perversity	 p e r v e r s i t y |
yield	 y i e l d |
waters	 w a t e r s |
ripping	 r i p p i n g |
unlike	 u n l i k e |
joshua	 j o s h u a |
divine	 d i v i n e |
assistance	 a s s i s t a n c e |
cook	 c o o k |
rather	 r a t h e r |
thorough	 t h o r o u g h |
empiricist	 e m p i r i c i s t |
conquer	 c o n q u e r |
worthy	 w o r t h y |
fool	 f o o l |
scarlet	 s c a r l e t |
loincloth	 l o i n c l o t h |
costume	 c o s t u m e |
carry	 c a r r y |
speculate	 s p e c u l a t e |
future	 f u t u r e |
christmas	 c h r i s t m a s |
problem	 p r o b l e m |
compared	 c o m p a r e d |
polynesian	 p o l y n e s i a n |
givingfeast	 g i v i n g f e a s t |
peeled	 p e e l e d |
shirt	 s h i r t |
defy	 d e f y |
solomon	 s o l o m o n |
island	 i s l a n d |
sore	 s o r e |
skippers	 s k i p p e r s |
nakatas	 n a k a t a s |
gymnastics	 g y m n a s t i c s |
served	 s e r v e d |
translation	 t r a n s l a t i o n |
symptoms	 s y m p t o m s |
pneumonia	 p n e u m o n i a |
influence	 i n f l u e n c e |
maddening	 m a d d e n i n g |
pounded	 p o u n d e d |
overtures	 o v e r t u r e s |
minor	 m i n o r |
afflictions	 a f f l i c t i o n s |
mention	 m e n t i o n |
tuesday	 t u e s d a y |
17	 1 7 |
cheerful	 c h e e r f u l |
alacrity	 a l a c r i t y |
weak	 w e a k |
prolonged	 p r o l o n g e d |
immersion	 i m m e r s i o n |
hesitated	 h e s i t a t e d |
mastered	 m a s t e r e d |
temper	 t e m p e r |
beneath	 b e n e a t h |
suffocating	 s u f f o c a t i n g |
drowning	 d r o w n i n g |
knee	 k n e e |
agonizing	 a g o n i z i n g |
hunters	 h u n t e r s |
arguing	 a r g u i n g |
roaring	 r o a r i n g |
semihuman	 s e m i h u m a n |
amphibious	 a m p h i b i o u s |
amended	 a m e n d e d |
squeamish	 s q u e a m i s h |
ships	 s h i p s |
altruistic	 a l t r u i s t i c |
welfare	 w e l f a r e |
knowing	 k n o w i n g |
scandinavian	 s c a n d i n a v i a n |
myths	 m y t h s |
clearer	 c l e a r e r |
understanding	 u n d e r s t a n d i n g |
grumbling	 g r u m b l i n g |
outbursts	 o u t b u r s t s |
continually	 c o n t i n u a l l y |
occurring	 o c c u r r i n g |
nicer	 n i c e r |
quarrel	 q u a r r e l |
sad	 s a d |
therefore	 t h e r e f o r e |
hurrah	 h u r r a h |
farther	 f a r t h e r |
rumors	 r u m o r s |
originate	 o r i g i n a t e |
end	 e n d |
resources	 r e s o u r c e s |
beauty	 b e a u t y |
york	 y o r k |
crash	 c r a s h |
29th	 2 9 t h |
foggy	 f o g g y |
